1 1 1 1 1 1 1 1 1 1 1 1 1 1 1 1 1 1 1 1 1 1 1 1 1 1 1 1
1 6 6 6 6 6 6 6 6 6 6 6 6 1 1 6 6 6 6 6 6 6 6 6 6 6 6 1
1 6 1 1 1 1 6 1 1 1 1 1 6 1 1 6 1 1 1 1 1 6 1 1 1 1 6 1
1 7 1 1 1 1 6 1 1 1 1 1 6 1 1 6 1 1 1 1 1 6 1 1 1 1 7 1
1 6 1 1 1 1 6 1 1 1 1 1 6 1 1 6 1 1 1 1 1 6 1 1 1 1 6 1
1 6 6 6 6 6 6 6 6 6 6 6 6 6 6 6 6 6 6 6 6 6 6 6 6 6 6 1
1 6 1 1 1 1 6 1 1 6 1 1 1 1 1 1 1 1 6 1 1 6 1 1 1 1 6 1
1 6 1 1 1 1 6 1 1 6 1 1 1 1 1 1 1 1 6 1 1 6 1 1 1 1 6 1
1 6 6 6 6 6 6 1 1 6 6 6 6 1 1 6 6 6 6 1 1 6 6 6 6 6 6 1
1 1 1 1 1 1 6 1 1 1 1 1 0 1 1 0 1 1 1 1 1 6 1 1 1 1 1 1
0 0 0 0 0 1 6 1 1 1 1 1 0 1 1 0 1 1 1 1 1 6 1 0 0 0 0 0
0 0 0 0 0 1 6 1 1 0 0 0 0 0 9 0 0 0 0 1 1 6 1 0 0 0 0 0
0 0 0 0 0 1 6 1 1 0 1 1 1 2 3 1 1 1 0 1 1 6 1 0 0 0 0 0
1 1 1 1 1 1 6 1 1 0 1 0 0 0 0 0 0 1 0 1 1 6 1 1 1 1 1 1
0 0 0 0 0 0 6 0 0 0 1 0 0 0 0 0 0 1 0 0 0 6 0 0 0 0 0 0
1 1 1 1 1 1 6 1 1 0 1 0 0 0 0 0 0 1 0 1 1 6 1 1 1 1 1 1
0 0 0 0 0 1 6 1 1 0 1 1 1 1 1 1 1 1 0 1 1 6 1 0 0 0 0 0
0 0 0 0 0 1 6 1 1 0 0 0 0 0 0 0 0 0 0 1 1 6 1 0 0 0 0 0
0 0 0 0 0 1 6 1 1 0 1 1 1 1 1 1 1 1 0 1 1 6 1 0 0 0 0 0
1 1 1 1 1 1 6 1 1 0 1 1 1 1 1 1 1 1 0 1 1 6 1 1 1 1 1 1
1 6 6 6 6 6 6 6 6 6 6 6 6 1 1 6 6 6 6 6 6 6 6 6 6 6 6 1
1 6 1 1 1 1 6 1 1 1 1 1 6 1 1 6 1 1 1 1 1 6 1 1 1 1 6 1
1 6 1 1 1 1 6 1 1 1 1 1 6 1 1 6 1 1 1 1 1 6 1 1 1 1 6 1
1 7 6 6 1 1 6 6 6 6 6 6 6 0 8 6 6 6 6 6 6 6 1 1 6 6 7 1
1 1 1 6 1 1 6 1 1 6 1 1 1 1 1 1 1 1 6 1 1 6 1 1 6 1 1 1
1 1 1 6 1 1 6 1 1 6 1 1 1 1 1 1 1 1 6 1 1 6 1 1 6 1 1 1
1 6 6 6 6 6 6 1 1 6 6 6 6 1 1 6 6 6 6 1 1 6 6 6 6 6 6 1
1 6 1 1 1 1 1 1 1 1 1 1 6 1 1 6 1 1 1 1 1 1 1 1 1 1 6 1
1 6 1 1 1 1 1 1 1 1 1 1 6 1 1 6 1 1 1 1 1 1 1 1 1 1 6 1
1 6 6 6 6 6 6 6 6 6 6 6 6 6 6 6 6 6 6 6 6 6 6 6 6 6 6 1
1 1 1 1 1 1 1 1 1 1 1 1 1 1 1 1 1 1 1 1 1 1 1 1 1 1 1 1